Tutorial 1
iJtrl
0
100
0 0 0 0 0 0 0 0 0 0
0 0 0 0 0 0 0 0 0 0
3 1 100 255 100 2 0 50 10 2 0 250 10 0 0 0 0 0 0 0 0 0
2 2 0 150 10 2 0 350 10 0 0 0 0 0 0 0 0 0
2 2 0 25 10 2 0 75 10 0 0 0 0 2 2 0 125 15 2 0 175 5 0 0 0 0
0 0 0 0 0 0 0 0 0 0
2 2 0 50 15 2 0 250 15 0 0 0 0 2 2 0 150 15 2 0 350 15 0 0 0 0
2 2 0 50 5 2 0 250 5 0 0 0 0 2 2 0 150 10 2 0 350 15 0 0 0 0
2 2 0 50 15 2 0 250 10 0 0 0 0 2 2 0 25 10 2 0 275 10 0 0 0 0
0 0 0 0 0 0 0 0 0 0